NO imgs/xmp/wall/wall1.xpm
SO imgs/xmp/wall/wall2.xpm
EA imgs/xmp/wall/wall3.xpm
WE imgs/xmp/wall/wall4.xpm

F 255,0,0
C 0,0,255

11111111111111
10010000000001
1000000N000011
11000010000001
10000010000001
10000000010001
10001000010001
10000000000001
10001000000001
10000000000001
11111111111111